WWWWWWWWWWWWWWWWWWWW
W.....WWW..........W
W.WWW...WW.WWWWWWW.W
W...WWW.W..........W
W.WWW.....WWWW.WW.WW
W..W..W.WWWWWW.W...W
W.WW.WW........WWW.W
WWW..W..WWWWWW..WW.W
WW..WW.WWWW..WW.WW.W
WW.WW..WW.....W.WW.W
WW..WWWW.SWWWWW.WWWW
WWW........WWW....WW
WWWWW..W.W...W.WWWWW
W...W.WW.WWW.W....WW
W.W.W.W...W..W.WW..W
W.....W.W.W.WW..WWWW
WWW.WWW.W.W.WWW....E
WWW.....W.W...WWWWWW
W...WWWWW.WWW.....WW
WWWWWWWWWWWWWWWWWWWW
